0,1,2,1,5,1,1,1,1,5,1,2,1,0,5
1,1,2,1,5,1,2,2,1,5,1,2,1,1,5
2,2,2,1,5,1,2,2,1,5,1,2,2,2,5
1,1,1,1,5,1,1,1,1,5,1,1,1,1,5
6,6,6,6,6,6,6,6,6,6,6,6,6,6,6
1,1,1,1,5,1,1,1,1,5,1,1,1,1,5
1,2,2,1,5,1,2,2,1,5,1,2,2,1,5
1,2,2,1,5,1,2,2,1,5,1,2,2,1,5
1,1,1,1,5,1,1,1,1,5,1,1,1,1,5
6,6,6,6,6,6,6,6,6,6,6,6,6,6,6
1,1,1,1,5,1,1,1,1,5,1,1,1,1,5
2,2,2,1,5,1,2,2,1,5,1,2,2,2,5
1,1,2,1,5,1,2,2,1,5,1,2,1,1,5
0,1,2,1,5,1,1,1,1,5,1,2,1,0,5
6,6,6,6,6,6,6,6,6,6,6,6,6,6,6
