1,2,2,1,1,0,1,0,1,0,0,0,0,0,1
1,6,6,6,2,1,5,1,5,1,1,1,1,1,2
2,6,5,6,2,0,1,5,1,0,0,0,0,0,1
2,6,6,6,1,1,5,1,5,1,1,1,1,1,2
1,1,2,2,1,6,1,6,1,0,0,0,0,0,1
1,1,6,6,6,6,6,6,6,1,1,1,1,1,2
1,5,1,1,6,6,1,1,6,1,1,2,1,1,2
0,1,2,1,0,6,1,1,6,1,1,1,2,1,2
0,1,1,5,1,6,6,6,6,1,2,1,2,1,2
6,0,0,1,1,1,1,1,1,2,1,1,2,1,2
6,0,0,1,1,2,2,2,2,2,1,1,2,1,2
6,0,0,1,1,2,2,2,2,2,1,1,2,1,2
6,0,0,1,1,2,2,2,2,2,2,2,2,1,2
6,0,0,1,1,2,2,2,2,2,2,2,2,1,2
6,0,0,1,1,2,2,2,2,2,2,2,2,1,2
