0,1,2,0,5,0,0,0,0,5,0,0,0,0,5
1,1,2,0,5,0,0,0,0,5,0,0,0,0,5
2,2,2,0,5,0,0,0,0,5,0,0,0,0,5
0,0,0,0,5,0,0,0,0,5,0,0,0,0,5
6,6,6,6,6,6,6,6,6,6,6,6,6,6,6
0,0,0,0,5,0,0,0,0,5,0,0,0,0,5
0,0,0,0,5,0,0,0,0,5,0,0,0,0,5
0,0,0,0,5,0,0,2,0,5,0,0,0,0,5
0,0,0,0,5,0,0,0,0,5,0,0,0,0,5
6,6,6,6,6,6,6,6,6,6,6,6,6,6,6
0,0,0,0,5,0,0,0,0,5,0,0,0,0,5
0,0,0,0,5,0,0,0,0,5,0,0,0,0,5
0,0,0,0,5,0,0,0,0,5,0,0,0,0,5
0,0,0,0,5,0,0,0,0,5,0,0,0,0,5
6,6,6,6,6,6,6,6,6,6,6,6,6,6,6
